...###
..##.#.####################
.##..###..................#
##........##..###.######..#
#...@..#..#.##...#.....#..#
###..###......#..#.$....#.#
..#..#....#......######...#
.##.##.#.##################
.#......##
.#...;.##
.#######